MMMMMMMMMMMMMMMMMMMMMMMMMMMMMMMM
MVVVTTTTTTTTRVTTTTTTTTTTTTTTTTTM
MTTTTTTRTTTDTTTTTTTTTTRTTTTVTTTM
MTTTTVTTTDTTVTTTTTTTTTTTTDTTTTTM
MTTTTTTTRTTTTTTTTTTVTTTRTTTTTTTM
MTTTTTTTTTTTVTTTTTTTTTTTTTTTVTTM
MTTTTTTTVTTTTTTTPTTTTTDTTTTTTTTM
MTTTTTTTRTTTTTTTVTTTRTTTTTTTTTTM
MTTTTTTTTTTTTTRTTTTTTTTTTDTTTTTM
MTTTTTTTTVTTTTTMTTTTVTTTTTTTTTTM
MTTTTRTTTTTTTDTTTRTTTTDTTTTTTTTM
MTTVTTTTTTTTTTTTTTTTTTTTTTVTTTTM
MTTTTTTTTTRTTTTTTVTTTTTTTTTTTTTM
MTTTTTTVTTTTTDTTTTTTTRTTTTTTTTTM
MTTTTTTTRTTTTTTVTTTTTDTTTTTVTTTM
MMMMMMMMMMMMMMMMMMMMMMMMMMMMMMMM