MTTRTTTTRTTTDTTTTTTRTTRTTTTVTTTM
TTTTTVTTTDTTVTTTTTTVTTTTTDTTTTTM
TTTTTTTTRTTTTTTTTTTVTTTRTTTTTTTM
TTTRTTTVDVTTVTTTTRTVTTTTTTTTVTTM
TTTVTTTVMTTTTTTTTTTVTTTRTTTTTTTM
TTTVTTTTTTTTVTTTTTTVTTTTTTTTVTTM
MTTMTTTTVTTTTTTTTTTTTPTTTDDTTTTT
MTTTTTTTRTTTTTTTVTTTRTTTTTTTTTTT
MTTRTTTTTTTTTTRTTTTTTTTTTDTTTTTT
MTTTTTTTTVTTTTTTTTTTVTTTTTTTTTTT
MTTTTRTTTTTTTDTTTRTTTTDTTTTTTTTT
MTTVTTTTTTTTTTTTTTTTTTTTTTVTTTTT
MTTRRTTTTTRTTTTTTVTTTTTTTTTTTTTT
MTTTTTTVTTTTTDTTTTTTTRTTTTTTTTTM
MTTTTTTTRTTTTTTVTTTTTDTTTTTVTTTM
MMMMMMMMMMMMMMMMMMMMMMMTTTTTMMMM