MMMMMMMMMMMMMMMMMMMMMMMMMMMMMMMM
MTTTTTTTTTTTRVTTTMTTTTTTTTTTTTTM
MTTTRRRTRTTTDTTTTMTTTTRTTTTVTTTM
MTTTDDDTTDTTVTTTTMTTTTTTTDTTTTTM
MTTTTTTTRTTTTTTTTMTVTTTRTTTTTTTM
MTTTDDDTTTTTVTTTTMTTTTRTTTTTVTTM
MTTTRRRTVTTTTTTTTMTTTTDTTTTTTTTM
MTTTDDDTRTTTTTTTVMTTRTVTTTTTTTTM
MTTTVVVTTTTTTTRTTMTTTTVTTDTTTTTM
MTTTVVVTTVTTTTTTTMTTVTTTTTTTTTTM
MTTTTRTTTTTTTDTTTRVVTTDTTTTTTTTM
MTTVTTTTTTTTTTTTTMTTTTTTTTVTTTTM
MTTTTTTTTTRTTTTTTMTTTTTTTTTTTTTM
MTTTTTTVTTTTTDTTTMTTTRTTTTTTTTTM
MTTTTPTTRTTTTTTVTMTTTDTTTTTVTTTM
MMMMMMMMMMMMMMMMMMMMMMMMMMMMMMMM